3000110004
3101112214
0011226000
2022500010
0011021120
0211201100
0100042202
0003221100
5122111016
5000110006