3000110004
0100112210
0011226000
2022500020
0011021110
0111201100
0200042202
0003221100
0122110010
5000110006