3332111444
3111112214
3011226004
2022500201
1011021121
1211201101
1020042202
5003221106
5122111116
5551112666