3332554333
3100121013
3212112123
2112110624
5126021215
5121206215
4260112112
3212112123
3101210013
3334552333