3002000004
0100012010
0012110020
0012110620
1125020211
1120204211
0230112100
0200112100
0102100010
5000002006