3332111444
3100020014
3112112024
2112110621
1125020211
1120204211
1230112112
5202112116
5100200016
5551112666