3300110044
3111112214
0011226000
2022500200
1011021121
1211201101
0020042202
0003221100
5122111116
5500110066