1212112111
1112213111
1121114111
1121115211
1111126111
1111111111
1111222112
1122112111
1111212111
1111111112