1211111111
1112113111
1111114111
1111115211
1111126111
1111111111
1111222141
1221111111
1111311311
1111111112