1111111111
1112111111
1111111111
1121111111
1111111111
1111111111
1111222111
1111111111
1111111111
1111111111