0010000000
0000000000
0000000000
0000000000
0000000000
0000000000
0000000000
2222000022
0002202200
0000000000