0200000000
0001203000
0000004000
0020005200
0000026000
0000000000
0000222000
0220000000
0000000000
0000000002