1211111111
1132113111
1142114111
1152115211
1162126111
1112111111
1112222111
1222111111
1111111111
1111111112