0000000000
0000000000
2020002222
2000200002
0000000000
0000000000
0000100022
0000000000
0000000000
0000000000