3334554333
3101121013
3002221003
4112116664
5112112225
5222112115
4666112114
3001222003
3101211013
3334554333