3331111444
3101122014
3212220004
0212004320
1112112221
1222112111
0256002120
5000222126
5102211016
5551111666