3301111044
3101112014
0002200000
0112000650
0112112220
0222112110
0340002110
0000022000
5102111016
5501111066