3334554333
3101122013
3212221003
4212116624
5112112225
5222112115
4266112124
3001222123
3102211013
3334554333