3001111004
3101122014
0002220000
0112006520
0112112220
0222112110
0234002110
0000222000
5102211016
5001111006