3001100004
0101122010
0002220000
0112000650
0112112220
0222112110
0340002110
0000222000
0102211010
5000011006