3001111004
3101122014
0002000000
0112000650
0112112220
0222112110
0340002110
0000002000
5102211016
5001111006