3331111444
3101111014
3002220004
0112000650
1112112221
1222112111
0340002110
5000222006
5101111016
5551111666