3100000000
0100220000
0002222000
0022002200
0020000200
0000000000
0100220000
0002222000
0002002000
0000000000