3100000000
0002002000
0002222000
0100220000
0000000000
0020000200
0022002200
0002222000
0100220000
0000000000