3100000000
0000000000
0000100000
0022222200
0020000200
0020000200
0022222200
0000000000
0000000000
0000000000