3100000000
0100000000
0002200000
0022000220
0220002200
0220002200
0022000220
0002200000
0000000000
0000000000