3100000000
0100000000
0000022000
0220002200
0022000220
0022000220
0220002200
0000022000
0000000000
0000000000