3334554333
3161221613
3001111003
4122222214
5211661115
5111661125
4122222214
3001111003
3161221613
3334554333