3000000004
0101221010
0002002000
0102002010
1212222121
1212222121
0102002010
0002002000
0101221010
5000000006