3330110444
3101221014
3001111004
0122222210
0251226010
0103221420
0122222210
5001111006
5101221016
5550110666