3334554333
3101121013
3602112063
4112112114
5212662125
5212662125
4112112114
3602112063
3101211013
3334554333