3000110004
3101221014
0001111000
0122222210
0100220620
0230220010
0122222210
0001111000
5101221016
5000110006