3000000004
3101211014
0002502000
0112002110
1212222121
1212222121
0112002110
0002042000
5101121016
5000000006