3330000444
3101121014
3002062004
0112512110
1212222121
1212222121
0112142110
5002302006
5101211016
5550000666