3334554333
3111001113
3112002113
4112662114
5222112225
5222112225
4112662114
3112002113
3111001113
3334554333