3000000004
3112002114
0112002110
0222002220
0000001110
0000001110
0222002220
0112002110
5112002116
5000000006