3000000004
3100000014
0112002110
0112002110
0222112220
0222112220
0112002110
0112002110
5100000016
5000000006