3300000044
3112002114
0112002110
0222002220
0111001110
0111001110
0222002220
0112002110
5112002116
5500000066