3300000044
3100000014
0112002110
0112002110
1222112221
1222112221
0112002110
0112002110
5100000016
5500000066