3330110444
3112002114
3112002114
0222002220
0111001110
0111001110
0222002220
5112002116
5112002116
5550110666