0000000016
0100002000
0000002000
0222222020
0200000000
0000000020
0202222220
0002000000
0002000000
0000000000