0000000016
0100002000
0000002000
0222222000
0200000020
0200000020
0002222220
0002000000
0002000000
0000000000