0000000016
0100002000
0000002000
0022222000
0000000000
0000000000
0002222200
0002000000
0002000000
0000000000