0000000016
0122222000
0000002000
0222222020
0200000020
0200000020
0202222220
0002000000
0002222200
0000000000