0000000000
0000000000
0000000010
0022222200
0020000200
0020000200
0022222200
0000000000
0000000000
0000000000