0000000000
0030405060
0001000000
0022222200
0020000200
0020000200
0022222200
0000000000
0000000000
0000000000