0000000020
0102222210
1000000200
1202220200
1200020200
1200020200
1220000660
0020000660
0022222000
1100000000