3012012104
3112212114
1111001111
2212202122
1102112020
0200112011
2212222122
1111001111
5112122116
5012102106