3332112444
3122122114
3111001124
2212222122
1202111011
1102112021
2212122122
5211001116
5112212216
5552112666