3312012144
3112212114
1211001111
2212202122
1102112021
1200112011
2212222122
1111001121
5112122116
5512102166