3312102144
3112122114
1111001121
2212222122
1202110011
1102112021
2212022122
1211001111
5112212116
5512012166