3332112444
3112212214
3211001114
2212212122
1102112021
1201112011
2212222122
5111001126
5122122116
5552112666