3000110004
0102222010
0050112600
0202112220
1211001121
1211001121
0222112020
0032110400
0102222010
5000110006