3000110004
3102222014
0050112600
0202112220
1211101121
1211011121
0222112020
0032110400
5102222016
5000110006