3000110004
3102222014
0052110600
0222112020
1211011121
1211101121
0202112220
0030112400
5102222016
5000110006