3300110044
3102222014
0052110600
0222111020
1211021121
1211201121
0201112220
0030112400
5102222016
5500110066