3000002004
0001102000
0001100000
0200002020
0110110110
0110110110
0202000020
0000011000
0002011000
5002000006