3000002004
3001112004
0001110000
0220002020
0110110110
0110110110
0202000220
0000111000
5002111006
5002000006