3334552333
3111112103
3111110103
4620662064
5212112125
5212112125
4602660264
3010111113
3012111113
3332554333