3300002044
3001112104
0001110100
0220002020
0112110110
0110112110
0202000220
0010111000
5012111006
5502000066