3000000004
3002112004
0002110000
0110002022
0110110110
0110110110
2202000110
0000112000
5002112006
5000000006