3300000044
3002112004
0002110110
0110202022
0110110110
0110110110
2202020110
0110112000
5002112006
5500000066