0000000014
0000000040
0001000000
0022222200
0020000200
0020000200
0022222200
0000000000
0000000000
0000000000