3000000004
3101125014
0001126000
1122220021
1100110021
1200110011
1200222211
0004211000
5103211016
5000000006