3300000044
3102122014
0011125000
1122226021
1120110221
1220110211
1204222211
0003211100
5102212016
5500000066