3000000004
3101122014
0001125000
1122226021
1120110221
1220110211
1204222211
0003211000
5102211016
5000000006