3000000004
0101125010
0001126000
1102220020
1100110020
0200110011
0200222011
0004211000
0103211010
5000000006