3330110444
3122122014
3011125004
1122226021
1120110221
1220110211
1204222211
5003211106
5102212216
5550110666