3302000044
3012111004
0010111000
0202000220
0110112110
0112110110
0220002020
0001110100
5001112106
5500002066