3000000004
3002112004
0000112000
2202000110
0110110110
0110110110
0110002022
0002110000
5002112006
5000000006