3002000004
3002111004
0000111000
0202000220
0110110110
0110110110
0220002020
0001110000
5001112006
5000002006