3332000444
3012111104
3010111104
0202000220
0112110110
0110112110
0220002020
5011110106
5011112106
5550002666