3300000044
3002112004
0110112000
2202020110
0110110110
0110110110
0110202022
0002110110
5002112006
5500000066