3002000004
0002011000
0000011000
0202000020
0110110110
0110110110
0200002020
0001100000
0001102000
5000002006