3330000444
3002112004
3110112114
2202200110
0110110110
0110110110
0110022022
5112110116
5002112006
5550000666