3332554333
3012111113
3010111113
4602660264
5212112125
5212112125
4620662064
3111110103
3111112103
3334552333