3334224333
3150110513
3561111653
4011221104
2112222112
2112222112
4011221104
3561111653
3150110513
3334224333