3001221004
3101111014
0000110000
0111221110
0112222110
0112222110
0111221110
0000110000
5101111016
5001221006