3000000004
3101111014
0001111000
0122222210
0120220210
0120220210
0122222210
0001111000
5101111016
5000000006