3331111444
3101111014
3001111004
1122222211
1120220211
1120220211
1122222211
5001111006
5101111016
5551111666