0000000015
0100022000
0000220000
2022200000
0000000220
0220000000
0000022202
0000220000
0002200000
0000000000