0000000015
0100022000
0000220000
0002200000
0022000220
0220002200
0000022000
0000220000
0002200000
0000000000